#
.o
##########################
#                        #
# # # # # ###### # # ### #
# # # # #        # # # # #
# # # # # ###### # # # # #
# # # # #        # # # # #
# # # # # ###### # # # # #
# #o# # #        # # # # #
# ### # # ### ## # # # # #
          #MMMM#   .      
# ### # # ###### # # # # #
# #o# # #    <   # # # # #
# # # # # ###### # # # # #
# # # # #   ##   # # # # #
# # # # #        # # #o# #
# # # # # ###### # # ### #
#o                      o#
##########################
