3
-*&$
--------------------------
3-33333-33333-3333-3---3-3
3---3---3-----3  3-33-33-3
3---3---333---3333-3-3-3-3
3---3---3-----3--3-3---3-3
3---3---33333-3--3-3---3-3
---&----*------$----------
3-------3333  3333-------3
3333-3333        3333-3333
3333-3333   M    3333-3333
3-------3333333333-------3
--<-----------------------
333-333-33-3-3----333-3--3
3---3 3-3--3-3----3 3-3--3
333-333-33-3-3----3 3-33-3
3---3----3-3-3----3 3-3-33
333-3---33-3-3333-333-3--3
--------------------------