..........................
#.#####.#####.####.#...#.#
#...#...#.....#  #.##.##.#
#...#...###...####.#.#.#.#
#...#...#.....#..#.#...#.#
#...#...#####.#..#.#...#.#
...&....*......$..........
#.......####  ####.......#
####.####        ####.####
####.####   M    ####.####
#.......##########.......#
..<.......................
###.###.##.#.#....###.#..#
#...# #.#..#.#....# #.#..#
###.###.##.#.#....# #.##.#
#...#....#.#.#....# #.#.##
###.#...##.#.####.###.#..#
..........................